NO textures/try.xpm
SO textures/try.xpm
EA textures/try.xpm
WE textures/try.xpm

F 164,169,20
C 153,204,255

111111111111111111111
101000001000000000001
101010101011111110001
101010001000001000111
111110101111101011101
100000101000101000001
101111101011101111111
101000001010100000101
101011110010111110101
101010001010100010101
101110101010101010101
100000101010001010001
111111101011111011101
100000101000100010001
101110101110101110111
101000100000010010101
101011111111111010101
100010000000000010001
101010111011111111101
1N1000001000000000001
111111111111111111111







