NO textures/minecraft_stone_wall_mossy.xpm
WE textures/minecraft_stone_wall.xpm
SO textures/minecraft_stone_wall.xpm
EA textures/minecraft_stone_wall.xpm

C 1,19,73
F 15,6,40

1111
1001
1001
1001
1001
1001
1001
10S1
1001
1001
1111