NO textures/try.xpm
EA textures/try.xpm
SO textures/try.xpm
WE textures/try.xpm

C 35,19,73
F 15,6,40

111111111111111111111111
100000000000000000000001
100000000000000000000001
100000000000000000000001
100000000000000000000001
100000000000000000000001
100000000000000000000001
100000000000000000000001
100000000000N00000000001
100000000000000000000001
100000000000000000000001
100000000000000000000001
100000000000000000000001
100000000000000000000001
1111111111111111111111111