NO textures/wallpaperflare.com_wallpaper_1.xpm
SO textures/mv_hd.xpm
EA textures/isaac.xpm
WE textures/gaga_hd.xpm

F 149,200,216
C 14,77,146

        1111111111111111111111111
        1000000000110000000000001
        101100S001110000000000001
        1001000000000000000000001
111111111011000001110000000000001
10000000001100000111011111111111
11110111111111011100000010001
11110111111111011101010010001
11000000110101011100000010001
10000000000000001100000010001
10000000000000000001010000001
11000001110101011111011110011
11110101 1110101 100011010001
11111111 1111111 111111111111
