F 0, 18, 31
EA 				textures/E.xpm
  		 		WE   		textures/W.xpm



NO textures/N.xpm
		     
C 0,18, 0
	 			   


SO textures/S.xpm

        1111111111111111111111111
        1010000000110000000000001
        1111000001110000000000001
        1001000N00000000000000001
111111111011000001110000000000001
100000000011000001110111111111111
11110111111111011100000010001
11110111111111011101010010001
11000000110101011100000010001
10000000000000001100000010001
10000000000000000001010000001
11000001110101011111011110011
11110111 1110101 101011010001
11111111 1111111 111111111111





