NO textures/minecraft_stone_wall_mossy.xpm
WE textures/book.xpm
SO textures/minecraft_stone_wall.xpm
EA textures/minecraft_stone_wall.xpm

F 20,20,20
C 200,200,200

111111111111111111111
100000000000000000S01
100000000000000000001
011111111111111111111


