WE textures/purple_cheetah.xpm
SO textures/cheetah.xpm
EA textures/blue_cheetah.xpm
NO textures/pink_cheetah.xpm

F 255,253,208
C 135,206,250

        1111111111111111111111111
        1000000000110000000000001
        101100S001110000000000001
        1001000000000000000000001
111111111011000001110000000000001
100000000011000001110111111111111
11110111111111011100000010001
11110111111111011101010010000
11000000110101011100000010001
10000000000000001100000010001
10000000000000000001010000001
11000001110101011111011110011
11110111 1110101 100011010001
11111111 1111111 111111111111


