NO textures/try.xpm
SO textures/try.xpm
EA textures/try.xpm
WE textures/try.xpm

F 20,20,20
C 200,200,200

11111
11111
111S1
11111
11111
11111
11111
11111
11111
11111
11111
11111
11111
